R 500 500

NO ./textures/nothing.png

SO ./textures/eagle.png

WE ./textures/wall_3.png

EA ./textures/wall_2.png

S ./textures/pillar.png

F 0,0,0
C 255,255,255

    11111  111111
    10001  100201
  111000111100001
  111110010000001
11100000000000001
12000000000010001
10000000000000001
10200000000000S01
10000000000000001
10000011111100001
1000001    100001
1000001    100001
1100101    111001
1000001    100001
1011111    100001
1000001    100001
1100001    100001
1111111    111111